11111111111111111111111111
10000000000000000000000001
1CE000000000000000000000P1
10000000000000000000000001
11111111111111111111111111