1111111111111111111111111111111111111111111111111
1P0000000000000E1C1101000000000000000000000V00011
1001111111111000101111100000000C00000000000000111
100C00001C0000C0101111111111111000000000000000001
1C0000C00100C000101111111110000000000000000000011
1111111111111110001111110000000000000000000001111
10C0000000000000101111000000000000000000000011111
1011111111111111100000000000000C00000000000001111
10C000000000000010000000000000000000000C000011111
1111111111101111101111100000000000000000000000001
1000000000000000101111110000000000000000000000011
1C1C1C1C1C1C1C1C1C111111110000000C000000000000111
1111111111111111110111111111100000000000000111111
1111111111111111111111111111111111111111111111111