11111111111
11C1E111111
11P11111111
11111111111